
LevelId:3
LevelTag:default
StartRows:3
TimeBetweenNewRows:500
Start
33333333333
33333333333
33333333333
11111111111
11111111111
11111111111
11111111111
11111111111
22222222222
22222222222
22222222222
22222222222
22222222222
11111211111
11111211111
11111211111
11112121111
11112121111
11111211111
11111211111
11111211111
11122222111
11222222111
End


